
R 1280 720

NO ./textures/WALL38.xpm

SO ./textures/WALL66.xpm

WE ./textures/WALL68.xpm

EA ./textures/WALL74.xpm

S ./textures/barrel.xpm

F ./textures/cute_floor.xpm

C ./textures/ugly_floor.xpm

             11111111111111111111111111111
             1000021 123333110000000000001
             1011021 120000000000110000011
             100100011110000000111000011111
111111111111110000000000000000000111111
10000#000000000000000000000&011111
1111011111110100001101000100011
1111010000010100000100101010001
1100010000010000000000000000&011
1000#11101110000000000000000111
1000000000000000000000000000001
1000000000000000000000000000001
1000000000000000000000000000001
1000000010001000000000000000001
100000001000100000000T000000001
1#00000001001000000000000000001
1000000000110000000000000000001
1000000000000000000000000000001
1000000000000000000001010000001
1000000000000000000111011000001
1000000000000000000000000000111
10000000000000N0&00000000000011
112000011101010111111#000000011
11110111 1110101 1011110100111
11111111 1111111 11111111111111